****************
*         *   S*
*   **    *  ***
*    *    *    *
*    *    *    *
*  E *    *    *
*    *         *
****************