****************
*         *   S*
*    *    *  ***
*    *    *    *
*    *    *    *
*    *    *    *
*E   *         *
****************